1111111111
1010101011
1010101011
1010101011
1000000001
1111111111
